
NO                        ./tex/me.xpm

SO ./tex/me.xpm

WE       ./tex/me.xpm

EA ./tex/me.xpm


F    44, 38, 48
C    65,8,115



        1111111111 1111111111
11111111101100000111000110001
10000000001100000111011111011
11111111111111111111000010001
                   1010010001
1111111111 111111111010010011
10000000111101011100000010001
10000000000000000000000000001
100000001000000001010100W0001
11000101111101111111000000001                1111111
10000001 1000001 100011000001                1000001
11111111 1111111 101111111111                1000001
                 101                         1000001
                 101                         1000001
                 10111111111111111111111111111000001
                 10000000000000000000000000000000001
                 10111111111111111111111111111111111
                 101
                 101
                 101
                110111111111111
                100000000000001
                100000000000001
                111111111111111